Sub-Basement 0 0

FLR W W O W
FLR W O O W
FLR W O O O
FLR W W O O
OBJ W W O O Key-1

FLR O W O W
FLR O O O W
FLR O W O O
FLR O O W O
FLR O O W O

OBJ O W O W Journal-1
FLR O O W W
FLR O W O O
LDR O O O O
FLR O W O O

FLR O W O W
FLR O W O O
FLR O W O W
FLR W O O W
FLR D W O O

FLR O O W W
FLR O O W O
FLR W O W O
FLR O O W O
FLR O W W O