Upper Floor 0 0

FLR W O O W
OBJ W O O O Something
FLR W O O O
FLR W O O O
FLR W W O O

OBJ O O O W Something
FLR O O O O
OBJ O O D O Key-2
HLE O O O O
FLR O W O O

HLE O O O O
HLE O W O O
FLR O O O O
HLE O O O W
FLR O W O O

OBJ O O O W
FLR O W O O
FLR O O O O
HLE O O O W
FLR W W O O

FLR O O W W
HLE O W O O
LDR O O W O
OBJ O O W W Something
FLR O W W O