First Floor 2 2

LDR W O O W
FLR W O O W
FLR W O O W
HLE W O O O
FLR W W O O

FLR O O W O
OBJ O O O O Journal-3
FLR O O O W
OBJ O O O O Something
FLR O W O O

FLR O O O W
HLE O O O O
FLR O O O W
HLE O O O O
FLR O W O O

FLR O O O W
FLR W O O O
HLE O O O O
FLR W O O W
FLR O W O O

FLR O O W W
FLR W O W O
FLR O O W O
FLR O O W O
FLR O W W W